# Oggetti (A-Z)

Airhorn=Klaxon
Apparatice=Réacteur
Apparatus=Réacteur
Bee hive=Ruche
Big bolt=Grosse vis
Bottles=Bouteilles
Brass bell=Cloche
Brush=Brosse
Candy=Bonbon
Cash register=Caisse
Chemical jug=Produits chimiques
Clown horn=Klaxon
Coffee mug=Tasse
Comedy=Comédie
Cookie mold pan=Moule
Double-barrel=Fusil double-canon
Dust pan=Ramassette
Egg beater=Batteur à oeufs
Fancy lamp=Lampe
Flask=Fiole
Gift box=Cadeau
Gift=Cadeau
Gold Bar=Lingot d'or
Golden cup=Coupe dorée
Hair brush=Brosse à cheveux
Hairdryer=Sèche-cheveux
Homemade flashbang=GSS Artisanale
Jar of pickles=Bocal de cornichons
Key=Clé
Large axle=Grand essieu
Laser pointer=Pointeur laser
Magic 7 ball=Boule magique
Magnifying glass=Loupe
Metal sheet=Plaque
Old phone=Vieux téléphone
Painting=Peinture
Perfume bottle=Parfum
Pill bottle=Pillules
Plastic fish=Poisson en plastique
Red soda=Cola
Remote=Télécommande
Ring=Bague
Robot Toy=Jouet robot
Rubber ducky=Canard en plastique
Shotgun shell=Cartouche de pompe
Steering wheel=Volant
Sticky note=Note
Stop sign=Panneau STOP
Tattered metal sheet=Plaque déchirée
Teeth=Dentier
Toothpaste=Dentifrice
Toy cube=Rubik's Cube
Tragedy=Tragédie
V-type engine=Moteur en V
Wedding ring=Bague de mariage
Whoopie cushion=Coussin péteur
Yield sign="Cédez le passage"

# Oggetti + Collected (A-Z)

Airhorn collected!=Klaxon récolté!
Apparatus collected!=Réacteur récolté!
Bee hive collected!=Ruche récoltée!
Big bolt collected!=Grosse vis récoltée!
Bottles collected!=Bouteilles récoltées!
Brass bell collected!=Cloche récoltée!
Brush collected!=Brosse récolté!
Candy collected!=Bonbon récolté!
Cash register collected!=Caisse récoltée!
Chemical jug collected!=Produits chimiques récoltés!
Clown horn collected!=Klaxon récolté!
Coffee mug collected!=Tasse récoltée!
Comedy=Comédie récolté!
Cookie mold pan collected!=Moule récolté!
Double-barrel=Fusil double-canon récolté!
Dust pan collected!=Ramassette récoltée!
Egg beater collected!=Batteur à oeufs récolté!
Fancy lamp collected!=Lampe récoltée!
Flask collected=Fiole récoltée!
Gift collected=Cadeau récoltée!
Gold bar collected!=Lingot d'or récolté!
Golden cup collected!=Coupe dorée récoltée!
Hair brush collected!=Brosse à cheveux récoltée!
Hairdryer=Sèche-cheveux récolté!
Hive collected!=Ruche récoltée!
Homemade flashbang collected!=GSS Artisanale récoltée!
Item collected!=Objet récolté!
Jar of pickles collected!=Bocal de cornichons récolté!
Key collected!=Clé récoltée!
Large axle collected!=Grand essieu récolté!
Laser pointer collected!=Pointeur laser récolté!
Magic 7 ball collected!=Boule magique récoltée!
Magnifying glass collected!=Loupe récoltée!
Metal sheet collected!=Plaque récoltée!
Mug collected!=Tasse récoltée!
Old phone collected!=Vieux téléphone récolté!
Painting collected!=Peinture récoltée!
Perfume bottle collected!=Parfum récolté!
Pill bottle collected!=Pillules récoltées!
Plastic fish collected!=Poisson en plastique récolté!
Red soda collected!=Cola récolté!
Remote collected!=Télécommande récolté!
Ring collected!=Bague récoltée!
Rubber ducky collected!=Canard en plastique récolté!
Shotgun collected!=Fusil double-canon récolté!
Steering wheel collected!=Volant récolté!
Stop sign collected!=Panneau STOP récolté!
Tattered metal sheet collected!=Plaque déchirée récoltée!
Tea Kettle=Théière
Tea kettle collected!=Théière récoltée!
Teeth collected!=Dentier récolté!
Toothpaste collected!=Dentifrice récolté!
Toy cube collected!=Rubik's Cube récolté!
Toy robot collected!=Jouet robot récolté!
Tragedy=Tragédie récoltée!
V-type engine collected!=Moteur en V récolté!
Wedding ring collected!=Bague de mariage récoltée!
Whoopie cushion collected!=Coussin péteur récolté!
Yield sign collected!="Cédez le passage" récolté!

# Oggetti + Drop (A-Z)

Drop Airhorn : [G]=Lâcher Klaxon : [G]
Drop Ammo : [G]=Lâcher Munitions : [G]
Drop Apparatus : [G]=Lâcher Réacteur: [G]
Drop Bee hive : [G]=Lâcher Ruche : [G]
Drop Bell : [G]=Lâcher Cloche : [G]
Drop Big bolt : [G]=Lâcher Grosse vis : [G]
Drop Bottles : [G]=Lâcher Bouteilles : [G]
Drop Brass bell : [G]=Lâcher Cloche : [G]
Drop Brush : [G]=Lâcher Brosse : [G]
Drop Candy : [G]=Lâcher Bonbon : [G]
Drop Cash register : [G]=Lâcher Caisse : [G]
Drop Chemical jug : [G]=Lâcher Produits Chimiques : [G]
Drop Clown horn : [G]=Lâcher Klaxon : [G]
Drop Coffee mug : [G]=Lâcher Tasse : [G] 
Drop Comedy : [G]=Lâcher Comédie : [G]
Drop Cookie mold pan : [G]=Lâcher Moule : [G]
Drop Dust pan : [G]=Lâcher Ramassette : [G]
Drop Egg beater : [G]=Lâcher Batteur à oeufs : [G]
Drop Fancy lamp : [G]=Lâcher Lampe : [G]
Drop Flask : [G]=Lâcher Fiole : [G]
Drop Gift : [G]=Lâcher Cadeau : [G]
Drop Gold bar : [G]=Lâcher Lingot d'or : [G]
Drop Golden cup : [G]=Lâcher Coupe dorée : [G]
Drop Hair brush : [G]=Lâcher Brosse à cheveux : [G]
Drop Hairdryer : [G]=Lâcher Sèche-cheveux : [G]
Drop Homemade flashbang : [G]=Lâcher GSS Artisanale : [G]
Drop Jar of pickles : [G]=Lâcher Bocal de cornichons : [G]
Drop Key : [G]=Lâcher Clé : [G]
Drop Large axle : [G]=Lâcher Grand essieu : [G]
Drop Laser pointer : [G]=Lâcher Pointeur laser : [G]
Drop Magic 7 ball : [G]=Lâcher Boule magique : [G]
Drop Magnifying glass : [G]=Lâcher Loupe : [G]
Drop Metal sheet : [G]= Lâcher Plaque : [G]
Drop Mug : [G]=Lâcher Tasse : [G]
Drop Old phone : [G]=Lâcher Vieux téléphone : [G]
Drop Painting : [G]=Lâcher Peinture : [G]
Drop Perfume bottle : [G]=Lâcher Parfum : [G]
Drop Pill bottle : [G]=Lâcher Pillules : [G]
Drop Plastic fish : [G]=Lâcher Poisson en plastique : [G]
Drop Red soda : [G]=Lâcher Cola : [G]
Drop Remote : [G]=Lâcher Télécommande : [G]
Drop Ring : [G]=Lâcher Anneau : [G]
Drop Rubber ducky : [G]=Lâcher Canard en plastique : [G]
Drop Shotgun : [G]=Lâcher Fusil double-canon : [G]
Drop Steering wheel : [G]=Lâcher Volant : [G]
Drop Sticky note : [G]=Lâcher Note : [G]
Drop Stop sign : [G]=Lâcher Panneau STOP : [G]
Drop Tattered metal sheet : [G]= Lâcher Plaque déchirée : [G]
Drop Tea kettle : [G]=Lâcher Théière : [G]
Drop Teeth : [G]=Lâcher dentier : [G]
Drop Toothpaste : [G]=Lâcher Dentifrice : [G]
Drop Toy cube : [G]=Lâcher Rubik's Cube : [G]
Drop Toy robot : [G]=Lâcher Jouet robot : [G]
Drop Tragedy : [G]=Lâcher Tragédie : [G]
Drop V-type engine : [G]=Lâcher Moteur en V : [G]
Drop Walkie-talkie : [G]=Lâcher Walkie-talkie : [G]
Drop Wedding ring : [G]=Lâcher Anneau : [G]
Drop Whoopie cushion : [G]=Lâcher Coussin péteur : [G]
Drop Yield sign : [G]=Lâcher Panneau "Cédez le passage" : [G]

# Shotgun

Fire : [LMB]=Tirer : [Clic gauche]
Reload : [E]=Recharger : [E]
Turn safety on: [Q]=Activer la sécurité : [Q]
Turn safety off: [Q]=Retirer la sécurité : [Q]
