#Schermo delle impostazioni
#Regex del microfono / dispositivo di input audio
r:"^Current input device: \\n ([\s\S]*)$"=Périphérique d\'entrée actuel: \n $1

#Altre impostazioni
ENABLED=ACTIVÉ
MODE: Push to talk=MODE: Appuyer-pour-parler
MODE: Voice activation=MODE: Activation vocale
Master volume:=Volume général:

DISPLAY=AFFICHAGE
Frame rate cap:=Limite d'IPS:
Use monitor (V-Sync)=Utiliser la V-Sync
Uncapped=Sans limite
r:"^(\d|\d{2}|\d{3}) FPS$"=$1 IPS

Display mode:=Mode d'affichage :
Fullscreen=Plein écran
Windowed fullscreen=Fenêtré (sans bords)
Maximized window=Fenêtré (maximisé)
Window=Fenêtré
Gamma/Brightness:=Gamma/Luminosité:
ACCESSIBILITY=ACCESSIBILITÉ
Arachnophobia Mode=Mode arachnophobe

CONTROLS=CONTRÔLES
Look sensitivity:=Sensibilité:
Invert Y-Axis=Inverser Axe-Y
> Change keybinds=> Changer les touches
Push to talk:=Appuyer-pour-parler :
#Walk
Walk forward=Avancer

> Reset all to default=> Réinitialiser
> Confirm changes=> Confirmer les changements
BACK=> Revenir au menu

#Sezione keybinds
REMAP CONTROLS=CHANGER LES TOUCHES
Push to talk=Appuyer-pour-parler
Walk forward=Avancer 
Walk back=Reculer
Walk left=Se décaler (Gauche)
Walk right=Se décaler (Droite)
Jump=Sauter
Sprint=Sprinter
Crouch=S\'accroupir
Interact=Interagir
Ping scan=Scanner
Item primary use= Utiliser objet (Primaire)
Item Secondary use= Utiliser objet (Secondaire)
Item Tertiary use= Utiliser objet (Tertiaire)
Item drop=Lâcher objet
Item switch left=Changer d\'objet (G)
Item switch right=Changer d\'objet (D)
Item inspect=Inspecter objet
Replace furniture=Replacer de la déco
Turn furniture=Tourner de la déco
Store furniture=Stocker de la déco
Dance=Danser
Point=Pointer
Enable chat=Ouvrir le chat
Submit chat=Envoyer dans le chat

> Set to defaults=> Réinitialiser


#Controller

REBIND CONTROLLERS=COMMANDES MANETTE
